uuid,female,male,other,skip,total
006ec9c6-4a39-4a17-9b91-ee53e6af0f10,0,3,0,2,5
00d63545-e423-419a-9619-81be7d1e4f07,0,2,0,0,2
01392a26-4e42-4e7b-bdd1-535441cd0c99,5,0,1,1,7
015902be-61ff-47eb-93d5-245c8556addb,0,3,0,2,5
01e459d0-693e-4c08-8d70-69f73e6cf9c7,0,2,0,0,2
02196e2e-034a-4442-ae9b-227ca6005b65,5,0,1,0,6
0234c14c-ad6b-42c7-8871-70eacffdeea2,0,4,0,1,5
035b8d08-337c-4609-8bf3-254a1b265874,0,6,1,1,8
03a83f7c-c529-4283-bb73-2bfde3d0943d,0,6,0,1,7
03b462d8-e7d9-4721-b915-f1660db6dde8,0,1,0,0,1
03f585db-b05a-4e64-a365-cc6b45e5960a,0,4,0,1,5
0470d0bd-77b2-4251-9205-7cce74bd0e2a,0,2,0,0,2
048a25a8-32e8-44d8-9ad3-c5f48396f344,0,3,0,2,5
04cded72-5a00-420b-96a1-233178a5fd98,0,8,2,2,12
05c10190-73c8-41af-b588-34958a76aee6,0,8,2,1,11
05ff7717-01f9-4341-b702-4ca510fb7f48,0,2,0,0,2
060bb52e-ab80-41e2-a942-99235d710f36,0,8,2,0,10
0674de0a-7ded-4ae1-8463-076a89a842ba,0,2,0,0,2
06b767f9-b6ba-44af-af07-d676326b17fd,3,0,0,5,8
07105432-93ec-4653-9e94-1708b041829b,0,3,0,7,10
072e173f-b7d6-44b8-a772-96129ff05d6e,0,8,2,1,11
074da681-80b0-4a32-a776-4ad3fe9d756c,0,2,0,0,2
07603db2-9315-4645-8c47-882aa0fd1e4c,0,2,0,0,2
079bcfdc-603f-493a-95db-5505d927ea7e,0,4,1,6,11
08357332-fdea-4506-8dbc-97ab7dae3af0,0,2,0,0,2
08421645-3166-4a1f-b479-b02afed88558,3,0,0,2,5
089ebc5f-6a34-4ba7-a83d-bec3a4f2d08b,0,2,0,0,2
09f3024e-2686-48f5-b0e9-92cb600e08d0,0,4,0,1,5
0a314f40-9bc4-4890-910c-3771f35250a7,0,8,2,1,11
0ac11d61-1172-41f2-b78b-4a3b3e8643f5,8,1,1,1,11
0addda39-4c39-45a9-b50e-342567e758e9,0,3,0,1,4
0bc53893-4c97-422e-b743-fc7dfc2b8860,0,2,0,0,2
0c6d41cf-9d8a-4a35-afc7-a83f5abd6ca4,0,4,1,4,9
0c953708-7180-4cd2-8ef7-6f898b009d91,0,4,1,2,7
0cd4047f-57c9-4216-879e-3a144ea9c0b5,0,2,0,0,2
0cdaafc7-d5b6-4c6d-ab88-08a0e2f0b5df,0,1,0,0,1
0d8c004e-4600-4916-9b55-879bb9fd72bc,2,0,0,0,2
0e8cdac7-32fb-4b30-8183-980118040171,3,0,0,6,9
0ec3bdd6-140b-473d-806d-6ba089cf7a35,0,4,0,1,5
0fa9fa5c-919b-46bf-873d-cab36188ae3d,3,0,0,2,5
0faa559e-aad5-40eb-9af8-ead5e2569ebd,5,0,1,2,8
1104c06f-121f-41de-8e83-83f7e70586bb,0,5,0,0,5
110eeeb9-83a8-4665-b0c0-1d15c1ca4581,3,0,0,2,5
112a1e51-2cb8-4130-b5f8-97f002586e47,0,3,0,2,5
112b497d-25a4-4470-881f-8aa8d809b270,0,4,1,8,13
119acbef-666a-4a66-ab89-f7dba83b92b1,0,8,2,0,10
11f67522-fe67-4a70-a4a0-a1b970bc67cd,0,4,1,9,14
12426476-57f3-4cb5-aae2-963152957a7e,0,6,0,0,6
125420c7-6f68-40b2-8545-d5694a9b6641,0,8,2,1,11
128686c2-5036-40ca-9828-3f033eafe85f,0,2,0,0,2
1412b14e-79db-4fb6-b992-123edb1d1d9d,5,0,0,5,10
14230faa-4de1-40ce-9213-b6e672747aa4,0,2,0,0,2
14563ed5-0c70-4c58-9ad3-2d66a5f8d9ba,0,8,2,1,11
14e63933-cc55-48b9-8c79-fb863b3df4e1,5,0,1,2,8
15cd21ac-a796-411a-b8f5-9c7a284fb3c7,0,1,0,0,1
16c66a3b-144f-40fa-a808-1d7a0d788895,0,2,0,0,2
16eb20ed-8dfe-4983-aacb-d47cb3370ece,6,0,1,2,9
1714606a-af1e-4c96-b4dc-70e4c48bec4c,0,4,1,6,11
178ebfc5-039f-439c-89df-f2a07c829c67,0,4,1,7,12
17f0f8f7-0f91-4c4c-9fec-d30202f398af,0,5,1,2,8
17f3573d-2678-4345-b381-3d9538c3888d,0,5,1,0,6
17fc32ba-957c-4168-9d8e-d9e5da3a8db2,2,0,0,0,2
17ff84c0-bf87-42b5-8d7c-10cc1c809c60,0,3,0,2,5
1899d72a-0ed8-44b0-9761-22158a8c15ba,3,0,0,2,5
189d6f17-9ab3-4a68-9b8e-04eb80dfc5d6,0,2,0,0,2
18c58269-0484-48ae-acaa-05cee0f5def3,7,0,1,0,8
18ef86de-8f8d-4d47-a440-2e50dd015f49,0,8,2,1,11
194d77b8-b58d-4e73-81a5-a8ae19d3b616,0,2,0,0,2
19fe6867-1043-40e0-8037-f2ecd19e9a8d,0,2,0,0,2
1a36c7f2-0dae-459e-bd32-05ab406fb194,0,6,1,1,8
1a40e52d-dd82-4ff8-948c-10c88257d540,5,0,1,5,11
1a6d80a1-bd8a-4dd8-8b36-b9ac9bf2c218,7,0,1,1,9
1b55cea2-caab-41ac-9d5c-73a2d0dbe61d,0,2,0,0,2
1c72bb40-0ebb-454b-9d19-6c1cd0311089,4,0,0,6,10
1c9857a2-7bd5-44f9-80ff-5db7c84e8d3d,0,8,2,1,11
1ceee23b-1444-4d2e-aa92-6c489a335bad,1,1,0,0,2
1cef9106-b98a-4327-a9b2-0b62c829ea37,0,5,1,1,7
1d2be7a2-74c1-4dbc-aa33-8dbd59b197b9,0,4,0,4,8
1d55a112-afff-4791-b62e-32dee4c7c49f,0,5,1,1,7
1e177d03-fa4a-49dc-a88a-b1f23ae5cb85,0,8,2,1,11
1e4c27de-235a-40d2-a1bf-ea574389b9c1,0,5,1,1,7
1e81f8b5-5d0d-4e5b-bd36-6592b3fbc358,0,2,0,0,2
1eee06d0-eeae-4537-acf9-b46a9e97eb4a,5,0,1,3,9
1efae87d-37c6-4030-bb3d-8411e4a3ba9e,0,2,0,0,2
1f9608cf-b7dc-41a1-8271-2a048a6f89ca,0,7,0,1,8
1fd7d9a2-bd4e-42e9-86ca-cd01af0a6d51,0,11,3,1,15
20c94423-a34f-4ce5-af84-7c1da99b4746,0,2,0,0,2
215d8a97-e96c-4d4c-85d2-539dd72984f1,0,2,0,0,2
21627b6e-d3eb-4997-8899-88deec249ea5,0,3,0,2,5
217aa03b-1643-4771-a22f-5cf20094a5cc,0,3,0,2,5
21a59860-1667-4c39-a3e0-fe9865a3fc92,0,5,1,1,7
2240ef4d-6527-4d05-8b67-8172d82aec67,3,0,0,2,5
22a00865-817e-4071-9f0e-e597aa5f34be,0,2,0,0,2
2336766c-d128-4244-9a3a-f2c5dc808c80,7,0,1,1,9
2440a432-8219-4181-9697-165710aca0b0,0,3,0,7,10
24a55174-bada-4330-b5ca-74accbcf805f,0,5,1,6,12
24ab0c1a-4b3c-46c8-95a6-eb12b57a354b,0,3,0,2,5
25cab7d3-085e-4dff-b797-6f0323211cd7,0,1,0,0,1
25e6a1e1-1ac4-44f1-aab7-7f0e5e3f5a6c,7,0,1,1,9
25e7d85e-94f6-46f2-abd2-0087f64151de,0,5,1,7,13
26608c48-5569-414f-9d4f-c03f6d178ca3,2,0,0,0,2
26a6f2af-4645-402e-a809-4a154a9c557b,3,0,0,4,7
26d807e1-a0b6-41f7-9341-b80bb932dcf3,0,7,1,1,9
26d91fd6-4909-42b9-be90-1d4a51840e35,0,5,1,6,12
26f69008-31be-44d8-85d8-7d37c9e0c2b6,0,1,0,0,1
28179015-0942-4397-918d-d10e3e63ef2e,0,3,0,2,5
29242e25-d391-4307-ab2a-735620c01ebd,0,5,1,2,8
2a04c2c0-8a2e-4bb5-bfa0-876ee5e9cb70,0,2,0,0,2
2a7f04cf-3236-4fbc-a815-c9a86b669bbe,4,0,0,6,10
2a9e2e7e-909b-413b-b8af-8ee1ddee5241,0,8,2,2,12
2aa7cb96-3005-4cd5-b4c3-dcb612c4f6c6,0,7,0,1,8
2ac800af-9d62-4675-9cf7-d1a400917824,0,2,0,0,2
2b180e1e-4c3d-4a91-88fa-eb8cdc6fff25,0,3,0,2,5
2c247cd9-41b3-44bd-88c5-0e04dabbb3f9,3,0,0,2,5
2ccf3ccf-6224-4912-a619-597b388094ea,1,1,0,0,2
2d13043f-8882-4b5a-909c-1ab2523b522d,0,2,0,0,2
2db80852-b807-4d53-8dbd-2706254406e1,0,2,0,0,2
2e0270bb-f9ec-4679-b382-f988651ebbac,0,4,0,5,9
2e2365ef-d92d-42f4-a95b-90f58e2cac3b,0,2,0,0,2
2eda6dcf-b9d6-4f56-9b65-1dbd6b76cb3f,1,1,0,0,2
2f0bfa38-c734-4df7-b360-98de384f1d4b,0,5,1,7,13
2f28a24a-9d92-458f-8e44-a6f2f9f32b52,0,2,0,0,2
2fe68923-0774-4f93-a6d3-4ab712eb4d37,0,8,2,1,11
3025bb2c-d26b-4d06-b244-1cd57afbaae8,0,3,0,2,5
3053b750-ab5e-4325-963b-32db1d32d208,0,3,0,2,5
30b9236b-a9d5-434d-a38b-ba82438d7253,0,8,2,1,11
31955f9e-5ac7-422d-ab72-e1d4da3d11f8,0,4,0,6,10
31c00a35-b40b-4025-b3cc-600f2deb474c,0,2,0,0,2
330063c1-4c06-441d-95d0-efaf01eeff42,1,0,0,0,1
33968ba3-5d7a-4f47-a4c5-8f36911b9472,0,2,0,0,2
35020257-b191-4093-8d4c-0b5ca47d834f,0,6,1,2,9
35251fb1-b6da-49a4-972c-99c7dddfcd76,0,4,1,2,7
355e4c73-a1e7-4db0-ab74-d56a4b45cd74,0,3,0,5,8
357a216f-955b-4978-8060-cfd2c5a845a0,0,4,1,2,7
36312e79-785a-41e5-b39b-ef5d528be001,0,2,0,0,2
3665b0b1-83c9-4d6b-9c76-d97efeea8d6c,0,1,0,0,1
36cba76e-8e92-45eb-87a2-98bf1dc23b69,0,2,0,0,2
371895a5-ff72-4e09-a63b-7549da19df9e,0,3,0,6,9
3733da3b-9b11-4429-8747-1d7b2fddc9bf,0,8,2,1,11
37785d93-8ba7-4507-a55f-d96b9e9d0f10,4,0,1,4,9
37d09fe0-80a8-480f-9aaa-f0f24f8443f8,0,3,0,2,5
37d18b94-343b-4c03-9d2c-480c524298e2,0,6,1,0,7
3808d1a8-6a95-4498-803c-9072ee0e5a37,6,0,1,0,7
385fae12-9f60-473c-bfc1-afef9200bc73,0,6,1,1,8
38a0935f-f293-447d-ba30-dd387a46da80,0,8,2,1,11
38fddd21-9c79-40a7-b69c-f36bacfc451e,2,0,0,0,2
393a9426-7564-499e-b069-317c532b7230,6,0,1,1,8
39801167-19c0-473c-82d9-c5e1b66f129b,0,8,2,0,10
39d19be5-85bd-493c-8dab-335d01332f4e,0,9,2,2,13
39e3af9b-1d46-40f9-8633-44ca5c434292,0,3,0,2,5
3a2db7fd-7880-4a92-9b2c-3147dfcad701,0,1,0,0,1
3aa6a249-5bd1-4e23-9fd2-d60f002d6021,0,7,1,1,9
3af587f7-5e4d-4b69-ab04-85c76e80e773,0,3,0,2,5
3b1f545d-0d3e-47a6-b843-ee55b764ff4f,0,5,1,1,7
3bcf80a8-a8da-4401-a9ce-92d51a74fb06,0,8,2,1,11
3c2b25af-57f8-477f-96be-16f38d2ed235,0,2,0,0,2
3c572dbb-73d1-4c7b-89a4-da81d526dd6f,0,4,1,6,11
3c954110-6d5e-4a94-961e-0521887d749c,0,9,2,2,13
3cba0f9c-e814-4933-9c9d-1e7c9221f49a,3,0,0,2,5
3cd820a5-fa16-44bf-b5f0-de74c7931347,0,2,0,0,2
3dafa83e-398e-44c2-af09-b39fe6a0efe6,0,5,1,0,6
3db5005d-66da-4b34-83b4-bdb7879b756a,0,2,0,0,2
3dc382bc-ad8f-4b1b-9ae5-d4832e19ecbe,0,5,1,9,15
3e86fcd5-55ca-4585-a639-29e2bd922212,2,0,0,0,2
3ea8be04-e7df-4a56-813e-b3b4d8d521ac,2,0,0,0,2
3f2539aa-033f-45cd-a39b-3c1d8eba4c16,0,2,0,0,2
3f9b679e-9ea7-43c2-a4af-ef01c2d0eda6,0,2,0,0,2
3ff5cfaa-65a9-4af1-b631-8d7b6b3ebde3,0,5,0,4,9
3ff6bcab-3f9e-4f31-8c6a-360674cbf4b9,0,3,0,2,5
4077c1e0-21ce-4a38-b7ea-c9102d038684,0,2,0,0,2
40982350-d68b-446d-82f0-a6449b647fb7,0,2,0,1,3
40b92d15-873a-4df0-93b4-8bddc7be4fb6,0,10,2,2,14
414962c1-2ea3-4b09-b285-b2cd1b1b5405,0,2,0,0,2
419255fe-1962-429d-aaa3-e750246b2478,0,2,0,0,2
425f33c3-f1a0-4115-b245-050db464ed14,0,8,2,3,13
427d1a4a-07b5-49f6-b1d1-e5ec971909a6,0,2,0,0,2
43323b8c-fca5-4402-bb75-0781d1836c31,0,2,0,0,2
434c20d2-a0ab-4156-8913-dec41928c84d,0,6,1,1,8
43ba0553-02d7-4655-874b-319187a92334,0,4,1,1,6
43bf397e-1317-4eac-be64-d0e63f164bcd,0,2,0,1,3
4411f16f-754d-41da-91c9-4339b84bce1c,0,5,1,1,7
442f10cb-d3db-424e-8478-e5912d475fd8,1,1,0,0,2
4432f0a2-89e7-41e1-9a2d-ebb601e865a0,0,3,0,2,5
445df60e-9cd9-410c-96b9-5e92b237886d,0,5,0,5,10
44b5d793-b457-4290-9f60-ee538c25232b,5,0,0,5,10
44bba20c-8c69-4e5a-afee-2e8175e7f280,0,3,0,2,5
455ccd79-9de4-45fd-aa7f-d4903d9be5b1,0,3,0,2,5
4645208f-8a90-4281-8cd9-af2ee44f6455,0,4,1,8,13
46b798f7-c826-4c7d-b753-b691a7ae82ba,0,2,0,0,2
4723ebbc-d1a4-41c4-b6ee-d2c7bda12426,4,0,1,6,11
47ea65c9-b5e1-46bd-84a0-a74634417dbd,3,0,0,2,5
47febf67-7d8a-40bf-89df-8c08bae539c1,2,1,0,2,5
4908fc1a-2efd-4186-90ea-46f5ca30688c,0,3,0,2,5
4942133e-0b46-4fd8-9353-9c687e09a46b,0,8,2,1,11
49982d41-e87c-436e-bd21-fe86359ee28c,0,4,1,8,13
4a1229d5-d585-4fa4-8873-d9e48aa7c85a,0,6,1,1,8
4a3712ba-0239-484c-bc5b-749c63faa322,0,3,0,2,5
4a67a985-732b-4d56-98c2-0f8938b58fc9,5,0,1,1,7
4ae35626-39c6-44d9-a276-078ecfcdd757,0,3,0,2,5
4bb3582b-eaf5-4adb-9715-8571b4cacc48,0,6,0,2,8
4bef177c-5407-41f4-a45e-07c7cf51da43,0,8,2,1,11
4c4511a4-3c13-4996-a7b8-36a361be2be5,0,2,0,0,2
4c9b7cf1-f7d7-4c57-8f74-244cab7d5244,0,2,0,0,2
4cc72d04-54d1-4ab9-9f95-4ef23231336d,0,2,0,0,2
4cd8fb40-19f5-404f-b92f-791d0ba27acc,8,1,1,1,11
4ce98430-c839-4353-bb58-ae70d1767efa,0,2,0,0,2
4d0873cd-9acf-41be-a2a0-ee5dfa2ac67f,0,3,0,2,5
4df1b1fd-9d1f-4e21-b702-46d4f744506a,0,2,0,0,2
4e3d6630-7c4b-47cc-9453-79fb1fb76d32,0,2,0,0,2
4e678fb7-786b-458b-8d1c-315600b26b6c,3,0,0,2,5
4eec9d82-93e6-41fc-a1b5-480488f52f65,0,3,0,2,5
4f279b52-84b1-44ac-aa98-e136a537d949,0,2,0,0,2
4f5608a6-6879-4ffb-a4f0-6a58428e4b8d,0,6,1,0,7
4fb74696-57c9-4005-852e-87d481369736,0,2,0,0,2
501cb293-a970-49cd-a18f-69c97ef49ed6,0,2,0,0,2
506808bf-f8cd-48d5-af49-c1b3f4071223,0,2,0,1,3
506856b5-158b-4c3e-977c-83a617d4026e,0,8,2,1,11
506c98bb-69de-4045-9d62-a9356a73cd4e,0,8,2,1,11
508007ef-cb9c-4201-a20c-2362b539ce90,0,2,0,0,2
50fee64e-e008-4547-8ded-154257d5165a,1,5,2,7,15
510fa689-4b2b-458f-af5c-c83010966bb5,2,0,0,0,2
517c23c4-ca04-496f-bbdd-3a6e62d11a2e,0,4,0,7,11
517d096f-a13e-43ce-a466-9d4c4b775b67,0,7,1,0,8
5193525c-eaa2-4e37-a8a1-ab098372d295,0,8,2,1,11
51adf2a2-c477-446d-aeeb-cdc75e949020,0,5,1,0,6
51c9f7e8-81c6-407e-a637-f1c067bc5ae8,1,1,0,0,2
52121920-8baf-432f-ad0e-0bb02fdc2821,0,2,0,0,2
526c9d97-e4de-4812-b501-3c8bafa6a5da,0,2,0,0,2
52ab8dad-ccf5-4cee-9c9e-7ad615b78269,0,7,1,2,10
53a71838-351f-4272-b88a-525ae481746e,0,2,0,0,2
53b8e6e4-4995-4b51-ac12-2d91fcd96a8d,0,2,0,1,3
53ef081f-5e99-44f3-938c-36a8f454f8da,0,3,0,2,5
53f0d930-2ec3-426e-be88-d65ab0f1dc28,0,2,0,0,2
54330b84-3dcb-4276-bc30-cfcea7e5fa0e,1,1,0,0,2
543b030d-0e98-4d66-b6a0-a08fc45d90a5,5,0,0,5,10
545bc93e-6063-4f5e-97e6-f2e4db591fa6,0,3,0,1,4
546118d0-16e8-48a4-85f1-1f7b382c37d7,0,5,1,0,6
55b3527f-abdd-40cd-bbc0-fb0fd50ffd20,0,2,0,0,2
55f69579-056f-4b6d-bca5-b9d55edd94ca,0,3,0,2,5
5658fa48-7e49-4dae-afc0-05bf565371a6,6,0,1,2,9
57672200-b78e-45c7-af89-24dacc2ecf31,5,0,1,1,7
578fb5f8-a597-4995-92c4-5fc4b9c0770b,4,0,0,6,10
57a4ffe9-4b47-41f1-8d7b-ba7bc15e2656,0,4,1,0,5
5864fa32-8fb9-476d-ab44-457e6d44eb80,0,2,0,0,2
58b06470-e953-4cbf-ae74-af9026a2a8d3,0,3,0,2,5
58b0fb00-7e89-4819-ace8-f78ba309e3ed,0,2,0,0,2
58b4c9b1-0e6e-4aa4-9a40-a4104bb8fd6e,3,0,0,6,9
595a639c-420a-4744-b4ba-0c07d189801a,3,0,0,2,5
59614b96-6bf6-4204-afa1-1cd0e1505e05,3,0,0,7,10
59dafdb8-dda9-4ed4-8b1e-15dc22ef08a7,0,2,0,0,2
5a31542e-d3f8-4d94-a41c-982a733f69cc,0,2,0,1,3
5a743c30-271a-4c58-8506-803c1076c102,0,2,0,0,2
5b235d28-174e-4678-8cc4-92e791cdafb6,0,8,2,0,10
5c570203-609a-4f64-836b-166d5b2a25d3,0,2,0,0,2
5c8620ff-7351-45fb-b507-c0b31f7fbdc4,0,6,1,1,8
5c93dae6-8590-4252-8a90-9ddc2478c7ea,3,0,0,1,4
5d2810bf-90dc-473a-ad12-2b895c372ccf,5,0,1,0,6
5d6166fe-2cfc-443f-a866-c0e3d9166e62,0,2,0,0,2
5dbac607-ae35-438c-9afa-4c9522741d9d,0,3,0,7,10
5dde33a3-0790-425e-868e-d9c9801c1947,0,3,0,2,5
5e698bf8-9ba5-4647-9ce1-faa2842c2557,0,2,0,0,2
5eef5018-2185-4557-92e2-72f203250110,3,0,0,2,5
5f56f937-80ad-4755-9f1c-af4eb4c6d4c0,0,5,1,1,7
5f7a20bf-02fc-49dc-a0b6-2f0ff6447f2f,0,4,1,2,7
5fb106d9-7fc1-4581-a3ac-a1d2e668b8b5,0,3,0,7,10
60636e66-240b-48f8-827b-e68f0cf0e414,0,2,0,1,3
60cf009b-be21-45f2-b2d2-36832e829969,0,5,0,4,9
610531f9-0fb7-4a0b-b8d6-e78f6cf14593,0,5,1,1,7
6177e22e-6600-4081-8ba8-bf22f3ca8c56,0,2,0,0,2
61ae8f3b-de7b-4ecc-bf37-25db1dab2dcc,2,0,0,0,2
61af89c1-f516-4aca-b045-c241446e74bc,0,2,0,0,2
61bc8b8b-4c0f-4fbb-92b1-66fabdc2e8ed,2,0,0,0,2
6236e0c2-18db-4187-ac8e-55444e8849ca,0,5,1,0,6
629abcf8-4a1f-4f86-99c3-651050defe4f,0,4,1,7,12
62a7b50f-c78f-42b2-9ec9-88508cec9100,7,0,1,1,9
62dada3d-fba2-4c1e-ac31-dec160547733,4,0,0,1,5
62ea1487-2b34-4763-bf93-252535f285ce,0,4,2,7,13
62fc93fa-3c84-48ca-9ca8-81cdd19b1ad5,4,0,0,6,10
6314d012-4e4c-4816-a8e7-d8955b4e3712,0,7,0,1,8
633cb1c1-7f99-4e55-804d-e6f3661a76b7,3,0,0,2,5
635d56e1-9dd2-4e17-b521-c9544e5bfd05,0,3,0,2,5
63ae3470-0499-466e-9a5d-a164ac6e5e46,0,2,0,0,2
63b94d30-3080-46ef-8c5a-5477e888bf96,0,6,1,1,8
63c6237f-1aa1-4036-871c-dcb26a8b5961,0,5,1,0,6
63c63c3b-62dd-44fd-8ce1-0071692d9566,0,5,1,2,8
63d26958-a2c0-40dc-a7d0-9446baad521c,0,6,1,0,7
64b10801-3709-46d7-991a-0cd9ea24adf2,0,8,2,1,11
64de9548-5eb7-4705-8f5f-2ecceb44963f,3,0,0,1,4
6538576a-d20d-45b5-950e-319d9ef3e554,0,3,0,2,5
654186bc-2847-4abf-9add-58e1f2e261d3,0,8,2,0,10
6549860e-9bc7-4848-a2c9-7e98edf84f1b,0,2,0,0,2
65aafd95-f142-4b39-aab8-3d5b54fec620,2,0,0,0,2
65cd3336-861f-419e-b64f-75c33bdc1572,0,8,2,1,11
661c72f7-6fa1-4acd-850f-09ae0dc1ffe0,0,4,0,1,5
6625292b-8450-480d-b1f1-e69d2b749b60,0,2,0,0,2
66f56812-9425-4f08-ade6-33d329791026,0,1,0,0,1
67409fed-3b4a-4938-96a1-f7eb2b46c62d,0,3,0,0,3
67935a70-0f4c-44e5-92fd-e66ea5d923b3,0,1,0,0,1
67bd8a17-402c-4a67-b452-71877bb727c4,0,2,0,0,2
67c39271-baa2-44e0-8cae-a7c606be1a22,0,3,0,2,5
68792164-579b-436b-8206-aa1a4f355f39,0,5,1,1,7
6888056d-d8a5-40cc-b8ed-ddb0bcc6e942,3,0,0,2,5
689e82d3-10f4-4d20-9a3c-b486f4471b77,0,2,0,0,2
68e73959-5a79-4e5f-9971-f7a45d65eedc,0,8,2,0,10
690ce915-9e99-43c1-aecc-a029702000fb,0,8,2,1,11
691b8f06-afa2-4b8a-a4b2-0c39c52bf13d,0,6,0,7,13
695f7ad8-38f6-4499-94ad-4f83d135ba59,0,3,0,2,5
698367bc-6bf9-4266-a22a-c3c2b400e984,0,2,0,0,2
69c55b04-265d-4e8a-952d-cb76195e105e,0,4,0,6,10
69f0451d-57a8-4182-af56-2f69751f2cb9,0,2,0,0,2
6a615563-b98a-4dca-9af5-d1cbfb0fb57d,0,2,0,1,3
6a867ad2-3455-459e-834d-dfba15f0326a,0,5,1,1,7
6a9a0599-81a6-43fb-99e3-5ce1a5d920af,0,3,0,2,5
6b337d97-a087-474e-b241-282571eb3417,0,5,1,6,12
6b962053-8979-4202-9508-7645bf18e9e5,0,3,0,2,5
6c2faa6d-4123-4264-a57d-10fc6dd59e60,0,2,0,0,2
6c5b9bc7-7b3a-47e1-bbfb-5e043580b291,0,3,0,2,5
6d8f3514-df25-4802-a8a9-382e65442a1d,6,0,1,2,9
6e21c5bf-5fde-4529-8a9f-668979ddbb0c,0,1,0,0,1
6eb30644-09d2-4ef7-931b-7aaf7c0ecab3,0,2,0,0,2
6ec0b21c-a1ba-452c-b267-51dd8c9eb362,0,8,2,1,11
6f5cee17-63d3-415c-a968-1f25758dba84,0,4,1,2,7
6f9ca67c-5673-4c2f-aa59-3a34fa7d7264,5,0,0,5,10
7037ad70-939f-4f62-8c86-c1c14969d3dd,0,3,0,2,5
705139e6-14e6-43a0-b234-bc6f94490819,0,2,0,0,2
707ae52d-d84f-47e9-bc25-2ecc2a0f5bf7,0,4,0,6,10
7130836b-f70a-4ce8-8fb8-2a88a77ce9cb,0,8,2,0,10
71b2d32d-3ef6-42ba-b904-484331432aea,0,5,0,4,9
725ab2eb-60d9-4e33-a77c-94d7525671db,0,7,1,1,9
72b7d86b-48b3-4fe0-8874-567a91cbf796,0,3,0,1,4
7300f2be-bfeb-4c34-9df1-72215dc2af89,1,1,0,0,2
7313e47d-924b-4613-874b-58f74f43e8b8,1,0,0,0,1
7344117e-6590-4a48-a1b7-d867399f79c1,0,2,0,5,7
73985686-c3d6-4156-8d0a-87c2b7e99812,0,2,0,1,3
73a5b35f-3213-45bd-a0ed-28a3fd2bb52d,0,5,1,2,8
73aafbb1-89d1-4188-96ef-229b03c46a40,0,2,0,0,2
73c835cb-dfff-41bd-be74-70294d80c1ae,0,3,0,2,5
73d20306-d8cd-427b-99e8-6114e6235481,0,3,0,2,5
744adb0f-262d-4ad0-8a91-d86b97b675a3,0,4,1,6,11
74db8e1e-a387-4f41-b466-f071992833be,0,3,0,5,8
75525a89-efda-44f5-a508-09208a830d5a,5,0,1,1,7
7606eaae-1b72-4933-8d34-e9cdfe0bd028,0,6,1,1,8
7608c425-6ed4-4766-945d-b2c42cf59c57,0,5,0,0,5
76175396-c7f9-49ed-bbf2-7d2f3ec0e13f,0,8,2,1,11
762cb3ff-41c0-40df-83c7-9df082ecd67f,7,0,0,0,7
763f901e-38f6-4195-8619-81f8082b0ecc,0,2,0,0,2
764fa2ee-2054-4e4e-bce6-fdeb99e67f4c,0,4,0,1,5
767f956d-9105-4152-93e5-3504a8b380e4,0,4,0,1,5
770b4d33-670a-4ce2-b67d-5cb7951403d8,3,0,0,6,9
77203ee7-2c98-4a32-ba01-0760fbca7d3b,0,2,0,0,2
773e8856-3a9a-4a60-8d88-e56ca3350380,0,3,0,2,5
777bdf27-3fc8-4cb1-accc-7e3041253415,0,2,0,0,2
77c1e7f3-c7ce-4b00-8218-412e5e1640e1,2,0,0,0,2
77f8345f-d92c-4297-a130-2f43fbf39e47,0,3,0,2,5
78411197-7365-4c48-aff8-453853299bfa,0,3,0,2,5
7866b6a0-4b65-4025-a6cd-5c305580e402,0,1,0,0,1
795092b1-12f3-41af-adfb-3fd47b1c0ac0,0,4,0,6,10
7a1bad00-3502-4b57-a825-99def467dcb0,0,2,0,0,2
7a7457e2-665a-44ae-9358-957cbe0231bd,0,3,0,2,5
7abca9d1-9c79-4ac9-8d7c-e8b4d61e0c7c,0,4,1,6,11
7af76f43-21dd-45d4-a180-ead26e0e028a,0,2,0,0,2
7b5cc0b0-9a82-43cf-8f74-d085f66e2ee2,0,4,0,6,10
7b70bc02-bf84-40df-8603-db804ec612ff,0,2,0,0,2
7bbb897f-582d-4b61-8823-0f8bfdeb12a6,0,7,1,1,9
7ca3c392-f4c6-4389-bf7a-b4e28996e023,0,2,0,0,2
7cac3461-5ffc-435a-bf80-0da98883411d,0,3,0,2,5
7dab825a-5a8d-4704-938a-5e538cb0b7fb,0,2,0,0,2
7dcf2f2e-1f4f-43d5-a30c-fda9e0b3338a,4,0,1,5,10
7de7d0fd-f7d0-49c0-a264-acfbca6ff200,0,8,2,1,11
7dfffd64-ec7d-4135-8290-688a0bc5bd56,0,3,0,2,5
7e10c0fa-d7c7-4bd0-9b9b-7139c94c8d43,2,0,0,0,2
7e471e78-cd40-4ed7-835e-46c559958cd8,0,6,0,3,9
7e475a16-936c-4e01-92dc-c132ca8412d2,0,3,0,2,5
7e8c8a9d-4a84-4420-bb3a-02658ab42954,0,2,0,0,2
7f719522-06f9-4301-82cc-f169325c1804,0,2,0,0,2
80471ead-f3a4-4b58-be72-a35601bfbdd6,0,8,2,1,11
80fe67f3-e37c-4c67-b7eb-53595390d9ad,0,8,2,1,11
810d3e8c-dc9b-4b04-a71c-4126c57fed38,0,4,1,4,9
817a224e-f20c-454c-9738-71d354b3fb9f,0,2,0,0,2
818e29c1-b2a7-428e-8903-9df402a58081,0,3,0,6,9
81b8642c-9027-484b-8f15-eeca95267844,5,0,1,2,8
82019caf-31ca-45dc-8196-2a990d5788fd,0,6,1,0,7
82048c9c-8dff-4494-89c3-23792c041df9,1,1,0,0,2
82075ae4-edc5-49ee-8238-e071eb90e549,0,2,0,0,2
8259971b-5050-4f7c-8c5d-bd5b59ea2a8b,0,5,0,2,7
829cc18e-7c37-462b-83e7-035382ad9426,1,1,0,0,2
8327239e-4452-4d87-a444-2fe1dc910baf,0,2,0,0,2
833fc30c-e536-4bf0-9a26-94e6a87f1c8e,0,3,0,6,9
840be09b-3dcf-4f49-b1fd-2cb0a55a96ca,0,8,2,1,11
853ed865-a3e1-4eb2-9d72-f7004e3218d5,0,3,0,2,5
856b24c5-9053-4ff1-9bca-152c7c29391b,0,5,1,1,7
85ec2e05-3f4e-41b9-89ec-b666f8706126,0,3,0,7,10
86548b86-081e-4c07-abb0-439feda70821,0,2,0,0,2
86a48639-73d8-47fe-acd3-1e9cf7eac6d9,0,6,1,1,8
873c1670-ae20-4261-be82-28fe66b419e2,0,9,2,0,11
87409c8a-6132-4861-9a7d-cb1eddf735f3,0,2,0,0,2
87456ee6-e5e0-49af-ba5a-30acc7c27a00,0,3,0,2,5
87476b74-0f1d-40e5-ac06-f8fe01377c9d,0,2,0,0,2
878c5392-7685-4f5a-92a5-592635854ea1,0,4,1,7,12
879c714b-9be2-463d-9858-57bf980a4901,0,8,2,1,11
895737c8-14ce-4b80-b617-39f2983d3e18,0,3,0,2,5
8957dfaf-d7d7-4dc8-8028-8f577ed590e8,0,3,0,7,10
898664db-51a6-4f39-b7cb-e5af0bd3ad3b,5,0,1,1,7
898815b6-a23d-4647-a8b7-b9daaee27ac4,0,2,0,0,2
89c0aaf5-bf74-48d9-8833-ff91ca629fca,0,2,0,0,2
8a1556de-1378-49db-9b90-4ecb5c9654eb,0,4,0,6,10
8a464dff-f86e-4f04-81b6-10bf469c7d9c,3,0,0,6,9
8a70dd5f-4cbc-418b-b5d0-56889bc97352,0,8,2,2,12
8af997a2-b1c9-4162-ac00-81d2e311db99,0,5,1,1,7
8b2fd056-0f31-47b5-8264-6a18e9a6c020,2,0,0,0,2
8b41aca3-cf9d-4bfc-84fe-c11a83996540,0,2,0,0,2
8b8f6489-2398-45ce-8721-f4556b804b2b,0,2,0,0,2
8c08c600-b998-4ca3-8422-9608ec146019,1,0,0,0,1
8c288eb1-905a-43be-8469-1ebe76a7562b,0,5,1,7,13
8c301581-83db-40f3-86fe-cc03a5d006fa,0,8,2,2,12
8cd1ef6d-11db-4ed1-ad93-a6183fd26f82,0,3,0,2,5
8cf9da62-f33c-4983-b867-6d937f20c699,0,2,0,0,2
8d058167-9fe2-4378-b3ce-c0c7418b573b,0,2,0,0,2
8d110616-0a37-4617-ac41-84ca070b1c93,0,5,1,2,8
8d50604d-a6e7-47ec-aab6-310f3efd1551,1,1,0,0,2
8d6de607-0f81-4eec-97c3-4b7776e20ddf,5,0,0,3,8
8de510fc-c6f4-4eee-9b07-2e06dc277b27,2,0,0,1,3
8e6598df-b36a-43e3-812d-07e2dcf3d484,0,3,1,9,13
8eb0b0da-14ea-409f-9488-0fe0302b05a0,0,2,0,0,2
8ed05a1b-0d36-43bb-870e-c7945a42cfb8,0,4,1,7,12
8eda8f7f-d18b-4040-8b78-2865d79724fd,0,2,0,0,2
903f494e-7ebf-4998-8ed5-44371a44f6ec,0,2,0,0,2
90b0cfb2-9c91-40ff-814d-6a03fb752e7e,0,1,0,0,1
90d415ad-eee5-4a27-bca0-409758a71de3,0,6,1,1,8
91843b5e-1742-4469-801f-24b02d0889a5,0,5,1,1,7
919bde3f-5855-4962-9568-a5ec24d14de0,0,4,1,6,11
91e420f1-5afc-4b44-b385-ec79e895119d,0,8,2,0,10
92471a82-9531-4791-9b5c-8eb3488f0c12,8,1,1,3,13
925c36bb-a71a-4ed3-a6f2-12951d518145,0,2,0,0,2
928cdfda-21ca-44cb-ab96-e01bb617d8b0,0,2,0,0,2
92d55ea6-cc1c-493e-81d2-e8baf96eaa99,0,2,0,0,2
92ea88e8-1d9c-4410-bea2-b3e999d479b2,0,6,1,0,7
93626f72-302f-495e-ad92-8502b44e0211,1,1,0,0,2
937fda1e-50af-419f-90b4-4a313982988a,0,8,2,1,11
93a2cf8c-69ed-4747-bd59-70993332e490,0,3,0,7,10
93d7f728-8e67-46c8-8255-11140233c9b4,2,0,0,0,2
942f5a3a-0794-4e45-bbeb-039b505bc857,0,8,2,1,11
94a16c0b-0df5-46fc-9802-0c733efb7fd3,0,6,0,2,8
94c1b476-b7cf-4acb-a116-4fb2a5fa949b,0,2,0,0,2
9591845f-2768-4d81-8b44-983f55e577b0,0,4,1,5,10
962384d4-a17a-4f3d-ab26-e36f149a522c,0,9,2,0,11
96a4588b-631d-4e6a-8378-e0d27b1320ab,0,8,2,1,11
96ce492d-7fed-478a-930a-cfe09ec65e3f,0,6,1,1,8
97121ba7-8b11-4d51-a136-182c7fab664c,0,4,1,2,7
977349be-8835-437d-ae10-f7253fee7c38,0,5,1,1,7
986a377c-ff1d-48f1-b225-98b230c771a9,0,8,2,0,10
986f32d2-63f5-4d68-bdbf-d6deaebf3bfc,4,0,1,2,7
98a9ebe9-1c3c-46dc-87e8-480e747ff155,0,8,2,2,12
98afbf06-2d5f-4312-92b6-4718d64e64db,0,2,0,0,2
9a889bce-e979-4f86-9877-5c40bf81e2e9,0,2,0,1,3
9aab2493-b46e-4bf6-b897-d8115283354f,0,4,1,7,12
9af57b21-d56e-4d1a-ba96-dffd2a359168,3,0,0,2,5
9b484341-d5cf-4172-8ba6-ef135bc97742,0,2,0,0,2
9b7f7cc9-1b5f-49da-b773-262f40b51a5c,0,1,0,0,1
9baf187a-1a17-41ee-92ee-30f37c28b475,0,4,0,1,5
9bcc2838-d994-48d2-943c-1e1d74b7bbc2,0,2,0,1,3
9c465d85-6fe2-44bd-84a7-2e2c1da22358,0,3,0,2,5
9cf327ef-cb16-4262-b9de-212162c81085,0,2,0,0,2
9d338e8d-6bd3-4b51-a5f0-26381045aca5,2,0,0,0,2
9d68dd57-9846-49e8-a2ee-952e85a97bf0,0,6,0,0,6
9daebcd8-fed1-4e54-9196-aad9195f8f18,0,8,2,1,11
9dd6a9f2-0966-4164-8a08-d4a1baba0f8a,0,4,0,1,5
9df00c0c-3bdf-4b36-8a24-9bf34da27e1a,2,0,0,0,2
9e228b6c-4bad-4538-a72f-0fbf1e41539c,0,9,2,0,11
9e3f1f1e-e28f-47bd-a2db-2601dc3f67c4,0,8,2,1,11
9e980415-1ed6-49c7-9057-e0d2df8c015f,0,8,2,1,11
9eb80e71-015d-4dc0-81d9-840c74468947,0,6,1,1,8
9ec2e059-b974-4ace-b445-35f732cbc683,0,4,1,6,11
9fe7abcf-138d-4ce4-bd89-85f614b93ac2,2,0,0,0,2
a0d36a6e-9898-43ed-981f-82b3f879cbcb,0,4,0,1,5
a0fe99d7-1fc3-4ecd-bc16-65024a935afd,0,5,1,2,8
a180c854-c9ae-4160-b709-d495e8f4f27b,0,3,0,2,5
a2235ad7-0b3e-4ac7-969b-637ad09f4492,0,4,1,6,11
a25dd8d2-9fb0-4a3e-a691-6762c072318e,1,1,0,0,2
a2c1cbd6-1b9c-4240-97b7-fd6d991d4af2,0,2,0,0,2
a392e145-b985-428a-ad55-2a1eea5af2e5,1,1,0,0,2
a4040487-2f8c-4436-bbf6-1e73769d018e,0,4,1,2,7
a45103a4-36b4-4e38-9832-e0b8172ff791,0,4,1,2,7
a456bd9e-61ed-45bc-8259-dc274cea8b3f,2,1,0,5,8
a46f3f3a-99d4-4b53-b821-dfed47b604c4,0,2,0,0,2
a47f40f2-ac87-43b7-8ced-b5326ebef87e,0,3,0,2,5
a4cd7304-0d87-450f-a0db-85c115ccb9a3,0,2,0,0,2
a5762b11-d387-4181-811c-a275bf4d1a36,0,2,0,0,2
a583f669-4cd4-482b-8bf2-9daf2fc43332,0,5,1,1,7
a6ffc9d7-deef-44bf-a9bd-4d8a6377349f,0,5,1,8,14
a71245d8-54e8-405e-91b4-d59139f08941,4,0,1,1,6
a77106ab-877a-441e-a082-6ac82852ed5c,4,0,0,4,8
a981ae15-29ce-4e2b-80cc-84b4e99e5435,0,2,0,0,2
aa374b18-f8a9-4eeb-9e17-33bfdc3cbf9b,0,2,0,0,2
aa616d63-af31-4f3c-b922-29164146e431,0,4,1,7,12
aa94d97a-cfdd-4228-a53a-5999b166cb50,0,4,1,6,11
ab12138a-71b8-479f-91c3-73dfe779c0fa,2,0,0,0,2
ac193b70-3dd5-4948-be73-dbb064787bb1,0,5,1,0,6
ac1cbdaa-479b-40de-b687-96c524fa6234,0,3,0,1,4
acab142d-f12f-496c-8a25-5fc75c6193d6,0,8,2,1,11
acac5649-021b-49f4-b469-e5fceaf43793,1,1,0,0,2
acf4f793-1e60-4b0a-a1c5-4cf613719a75,0,3,1,8,12
ad1c41bb-258e-48c6-bfa9-981527273d03,0,2,0,0,2
ad89b0a5-063d-4308-9e5f-07404288ac27,0,8,2,2,12
ada29e04-1ebd-4d92-9e07-587e002927da,0,2,0,0,2
add06cdd-3a39-4cec-ac8b-c9fb49c932ed,0,3,0,2,5
ae669ca3-26bb-417d-a58c-96c161907539,0,8,2,1,11
ae67a916-2da9-4e16-b0c7-f1cb190cf616,0,2,0,0,2
ae89b51a-71fb-4c5e-91aa-85136dc4fefc,0,3,0,2,5
ae9dcbd4-fbae-4d65-bfff-f655d6e1981d,2,0,0,0,2
aea6f473-56b3-4b40-adac-8128f4127321,0,2,0,0,2
aec0060e-95a4-42c1-8bd9-d93af0539078,0,8,2,0,10
afefb16c-8e66-4af1-9dcf-7a9dd87bbb37,0,3,0,2,5
b0791ea7-82f7-4487-a5f1-352660933107,4,0,1,3,8
b0d6531b-a87d-4b20-9273-0606cff5f419,1,1,0,0,2
b15ff2b5-6ef8-4226-a49a-f64f58e1b2b2,0,3,0,7,10
b1baa7fb-b9c8-440c-886f-3d2e2498340e,3,0,0,2,5
b1cba83b-dee7-4b8a-90ed-76974801fe80,0,6,0,1,7
b1d9e348-bcb9-4873-a5d4-cc19aa267402,0,2,0,0,2
b1e90ea6-6337-49ba-9b77-645dd805abc2,0,8,2,1,11
b1eb6014-e0a3-408a-97ff-67b1c1f90f67,0,5,1,7,13
b1ecbd30-0777-436d-b0ab-b23f4dbef491,0,2,0,0,2
b2907579-4f83-4687-abfc-a1ed55b722ed,7,0,0,2,9
b336baec-0f36-4cd4-824b-a943cd6defa5,1,1,0,0,2
b35c2e49-d7e8-4d04-811c-42dcff2c7f18,0,5,1,1,7
b3db5c64-82c0-4f5b-bc30-d2bc8c6ab0fc,0,5,1,1,7
b4316549-a975-4f7c-b474-35a2cc8bbb01,0,8,2,1,11
b48b3ec2-dd95-4696-9983-a07262090eb9,2,0,0,0,2
b4e313d6-8d87-4141-9af8-6d51c53ccc1c,0,2,0,0,2
b4eb7a8f-d1c2-462f-9f4a-83515ceb1a47,0,4,1,3,8
b57bf9e5-7a72-4a17-8105-0a3ddabb59d8,2,0,0,0,2
b64271ad-0baf-4814-b38e-7acc220ddf33,0,4,1,5,10
b6de7cd8-cad2-4a5f-96c0-939f175e5b88,0,2,0,0,2
b751295a-dc0a-434c-af7b-d8c897a9f687,2,0,0,0,2
b79756d4-09a0-4afd-b33c-3b5946e5c3ef,0,2,0,0,2
b82c35fb-1ed2-497d-8bf5-6951f4f8721f,0,2,0,0,2
b91ee2ec-98f5-4a62-a1ec-e253014261a5,0,4,2,6,12
b97e751f-3b57-4713-a8ab-66a555249211,0,2,0,0,2
b9947c76-ef45-4b01-a5d3-0d1ae4249e45,0,3,0,2,5
b9f5ff14-2e0c-48c0-9c40-633f3ef2edef,0,5,1,7,13
ba1ddf78-fcc8-45b3-9057-4e5e64056d1c,0,3,0,1,4
ba8ca434-4694-4347-9113-c6abd4ffa503,0,2,0,0,2
bac1a50e-f9bb-4cc6-8e1e-456ab8a60d21,0,4,1,5,10
bb4be514-8962-414e-b55c-2def591ed2e4,0,2,0,0,2
bb7386fa-6835-4bdd-a740-58b93ed51e3c,0,4,1,2,7
bbec27a6-0168-4e02-8323-bd48d5a86cec,0,5,1,0,6
bc81cb34-985e-41e4-833e-e9fa486c96b3,0,2,0,0,2
bca39f87-4e8a-4720-aad1-4fe56e395186,5,0,0,4,9
bcf2a693-75da-41b8-9a29-a4dba66fc8b7,2,1,0,1,4
bd26404b-c180-407c-86df-00378900f9e9,4,0,1,4,9
bd275f55-7f77-4006-ad82-0ee910e1a64c,0,3,0,1,4
bd2b6104-7f7b-47b3-b6c9-ec09f20c8483,0,3,0,2,5
bd996022-b7ec-4457-ae47-b1a3111fa745,5,0,1,2,8
bdbbb256-762c-4eea-96e5-0b406d414c7b,0,2,0,0,2
bdd1e328-8616-4435-a38d-159464133196,7,0,1,1,9
be017ee4-a12b-4714-86c1-3959029aab32,0,8,2,2,12
be1f2d84-b995-4984-85da-d57d0f36e224,0,6,1,2,9
be4764fe-d089-417b-9fbf-f8460e06ac21,0,3,0,2,5
bed96bc3-339a-4f0e-a6e7-a82063a68fa7,0,2,0,0,2
bf425129-9ed1-423f-8c0c-925eb429bf02,0,8,2,2,12
bfb6fa9c-8642-472c-bf80-7d07dd8badcf,0,4,0,1,5
c015eb61-e66d-4314-986e-9727210fc358,0,2,0,0,2
c09951e7-9a30-4abc-8958-cd441bc3e779,1,0,0,0,1
c13c033d-448b-482a-b7af-53d183889c38,0,4,0,6,10
c1779193-fcd6-40b2-a6d0-265bf496a828,0,7,1,1,9
c1a550cb-d70f-4378-a443-0ee26cb00a84,0,3,0,6,9
c1b49bb6-659c-43fa-84df-777c757cca3e,0,5,1,2,8
c237965d-65cd-4f5e-bc9b-d5521a4a0737,0,6,1,0,7
c2421c0f-6ae3-40c8-bf8d-461ab92c8fc4,0,2,0,0,2
c24bbd95-29de-4979-b5cf-050010491aee,0,2,0,0,2
c2d4ea34-6f42-458d-bc56-cbb12bb292bb,0,8,2,0,10
c3726fc4-311d-4a1c-8b54-c44e9d3c4a21,0,2,0,0,2
c48f7cfa-b47d-4d00-b1e6-2574d4dab1ea,0,3,0,7,10
c49229f8-f7c9-4c7c-92ce-deb2d60428a5,0,8,2,2,12
c51cb6f4-f34c-4cde-a9ca-2769a8546704,0,5,1,0,6
c53e5e22-329e-456e-bddb-ce670e04667c,0,2,0,0,2
c55d193b-3274-433a-b41c-924f8b7191a3,6,0,0,1,7
c56bde2c-27e5-4929-ac73-dca3cc9081c7,0,3,0,2,5
c59cd475-cdd3-4cc7-ac6d-fd000eaf1a39,0,5,1,2,8
c5f258f6-ca46-4999-93f3-a2152a399a4c,0,8,2,1,11
c670a771-733d-4b66-b8c7-d4c7e6cfbb5b,0,8,2,0,10
c6f843c6-2485-4b38-937c-eb0fb0a24889,0,3,0,2,5
c714335d-eb2c-4161-b98d-743ce6711722,4,0,0,1,5
c733a66a-8046-456d-912e-805f30ea13d3,1,1,0,0,2
c73da909-fd42-460f-b1fa-2cc404825ac0,1,1,0,0,2
c7727281-7de7-4a4e-bbe5-5d64f10481e9,0,6,1,1,8
c7c8f715-d4ac-458d-b26f-61087db121ff,0,3,0,2,5
c7f2cae5-37dd-484d-9018-2b87d9a529e5,0,2,0,0,2
c87cee20-1667-46cc-89cb-3d0a705b892a,0,4,1,7,12
c97df20e-6f63-420e-a876-dd5ac6180776,0,5,1,7,13
ca8b9813-8573-47fc-a609-dbf2f1e4f458,0,5,0,5,10
cae8a13c-b009-4752-a273-0746cbd7e33d,0,2,0,0,2
cb0dba92-871e-4adf-a359-2b9ef53bd928,0,7,1,0,8
cb1b46c9-5253-412d-8d07-4a26cd18d802,0,4,1,6,11
cb3145b2-d9b0-482b-a7d0-5b5a5bc2decd,0,4,1,7,12
cb83c53f-022b-4551-8af3-6c9cb3770cd9,0,8,2,1,11
cbb6df69-820f-446d-a85e-9deb4abf0a0c,1,1,0,0,2
cbb85723-7771-45e7-a37c-82f4a793b0a8,0,9,2,2,13
cbc3c1b1-4543-49d1-8d64-e7934286a81f,2,0,0,0,2
cbdcd5e4-c579-4e47-a1b6-d47be721200c,0,3,0,7,10
cc815d91-a814-4239-bc17-a4678ae73e28,0,3,0,2,5
ccb644c6-a289-451c-b190-678bac13da45,0,3,0,2,5
ccf77188-167a-4036-a566-e7ee9b70796a,0,6,1,2,9
ce0ec914-ed28-4fc1-9c04-7f638ecb6d37,0,8,2,1,11
ce2b504d-3133-46ef-a695-37552a5b1d5a,0,5,1,0,6
ce4d73a8-2447-4295-9256-a0544d300d42,1,1,0,0,2
cec0729c-6e24-4757-a1b2-96123fb61cc4,0,8,2,1,11
cef3292b-8369-4952-9196-54e71a564168,0,3,0,2,5
cefbe50b-7687-4b3c-a7a3-62bd78103d29,3,0,0,2,5
cf29e3b9-8cc5-4f81-b1e0-5d2a0b18eae8,0,8,2,0,10
cfcbe415-90c7-49a9-a850-1c9b68eb4ee2,6,0,1,1,8
cfce3147-12e0-4b32-a06a-faa9635c5642,0,3,0,2,5
d036f5db-d99c-4b78-83f7-dfa1f1286af2,0,8,2,1,11
d05d4954-fd42-47bc-8e25-9179b9bee388,0,5,1,8,14
d0a27f3e-efee-4663-acff-3d3c35dd1e4a,3,0,0,0,3
d133f7aa-b14d-42d6-b913-dd215718b2b7,0,5,1,8,14
d1398b02-c30d-407d-81b6-a8893cd4c56b,0,3,0,2,5
d1836319-d22a-4306-9699-de6fcd531780,0,2,0,0,2
d1b7d50a-7548-4758-85c6-2abd2aae831b,0,5,1,1,7
d1e72741-a78e-4384-8a75-64f2390337e5,0,8,2,1,11
d21933d7-2a80-479b-99a6-97281c839445,5,0,1,1,7
d2391cc7-c7f2-41d8-8f23-8befe18c9c2f,0,8,2,1,11
d278368a-9cb7-46bf-88b8-e825f563ee1e,3,0,0,7,10
d334fffc-15f8-4328-a279-6cfe4007b664,0,3,0,0,3
d396dbb5-ab43-482f-b8c0-5dff8e2cb45d,0,9,2,1,12
d3ef87cd-aac0-4497-af33-5ba224884611,0,3,0,1,4
d498c496-516a-4aa9-9f02-bca40611df14,3,0,0,2,5
d49e7c6a-3580-482c-bd14-f50bfd710313,0,2,0,0,2
d548f71b-9b7f-46e6-9cee-e237f6314581,0,4,0,6,10
d55f003e-382d-4706-bf31-b243fed83a3c,0,4,0,5,9
d5d47b43-29df-4465-827b-9df7476ffdc6,5,0,0,5,10
d62a2f3d-a619-4f81-9820-6b724171e5ce,0,2,0,5,7
d6cbc13d-cd7f-40bd-a0de-35a887e9f275,0,3,0,3,6
d6edcb34-b765-42f3-b099-e1c171d44513,0,4,0,6,10
d6ff161a-7840-44d7-86a9-ca5b350dcc98,3,0,0,2,5
d71beee6-76b7-40f3-91df-d22d81b7b2c5,7,0,1,1,9
d71e690e-7b5f-4a87-b840-b4459aa6ba7e,2,1,0,2,5
d71f1eec-6363-431a-a6bf-a41471c1f1d1,3,0,0,2,5
d87cf450-29d1-48e1-9804-1f7d83626052,0,2,0,0,2
d8a53a48-c841-4d34-abd8-38047f072667,5,0,0,6,11
d8d72292-efa9-42a2-9455-23d18b4dcebe,0,3,0,7,10
d95c6fbf-da2c-4630-9fa1-8012c7ebf72f,0,3,0,2,5
da11c8f9-b04c-4533-9395-94813ef4b7a7,5,0,1,1,7
da1d72ec-8ba1-4419-ab59-7b54b94b391b,0,8,2,1,11
da4d2eca-2475-4160-808a-672b121b2232,0,7,2,2,11
daa1f327-2724-4f3e-803d-fbd4b57f1869,0,5,1,7,13
dab5ba6a-22bc-4575-85b7-918170c1e800,0,8,2,1,11
db21bf26-5a24-48c7-9097-bb4a167fce72,0,3,0,6,9
db5653c9-2c82-4770-adda-d4f1cc1eabac,0,3,0,2,5
db85c329-bcfc-4580-ae6b-ddc7cfd6f40a,0,5,1,9,15
db90d754-1c13-40fa-88a1-25590919e94a,0,2,0,1,3
dbc9b98c-eabe-403b-8a63-4f2ac637248e,6,0,0,1,7
dbd88650-5e92-4085-809b-9be7b3a8c98f,0,4,0,1,5
dbe7e0be-4f1f-4ff7-b5d3-db00e55629fc,1,1,0,0,2
dc182a49-385a-4f50-96a1-33e77fae96f6,0,6,1,1,8
dc3e1b11-caa3-469e-9c34-aa5db91a1d2c,0,2,0,1,3
dc666008-a86a-45ce-8adb-d96af2e1d94f,0,2,0,0,2
dc81842b-bc24-49ed-b77b-8635eb109271,0,3,0,2,5
dcdb674d-de9f-4c3d-9bbe-3581bd533178,0,4,1,7,12
dcef195e-9798-4338-ae5d-df065898ea7d,0,8,2,1,11
dda6aece-e0bb-4887-a1e5-d01f8c02351b,2,0,0,1,3
dee8fcb9-0881-466d-aaf7-84d66fd76785,7,0,1,1,9
df8613b5-d66e-4ec5-9ef9-a681830ff49a,1,2,0,5,8
dfac271a-a842-4bbb-bce0-d884c63be59e,0,2,0,0,2
dfdaeeb4-0bbe-4756-86d8-09d9a8afcc5d,0,8,2,1,11
dff9d96c-79d7-4258-95b1-2ebb227b6cc4,7,0,0,2,9
e035bfa8-3216-475f-94fa-c49227085e89,0,5,1,1,7
e0800219-94d7-487b-90e4-51e2b767bc80,0,4,1,8,13
e24ac259-0018-4763-8f59-0d6d5ee27da5,0,1,0,0,1
e290cf8d-3552-4b72-9400-1ed5672e8e71,5,0,1,1,7
e2999f31-18ec-443a-9245-9920232ffd58,0,3,0,1,4
e341c90b-3277-4663-b0f0-250433f0889a,0,8,2,1,11
e3c55227-601f-4c77-a13d-3a64ae6bff9d,0,2,0,0,2
e3db20ad-3633-4f31-b17f-7421c331f1b5,0,8,2,1,11
e41f2336-b36f-409d-bdc5-aa82e7150b5f,0,4,1,8,13
e4aba729-9a4f-4cd3-989d-3ac538e91d14,0,2,0,0,2
e4cbae3c-dc99-4bf3-b474-dcbb25bee31b,4,0,1,2,7
e4e140b1-93ce-4b6d-a2a9-79b41312cff6,0,2,0,0,2
e4e7a860-c3bd-4eff-bee7-c5c4772fb31f,4,0,1,2,7
e50cf146-a8ce-496f-bfd4-7bc7406cd2f4,2,0,0,0,2
e52f699e-e6a8-4c4e-9a35-ba2ed527d3bf,0,2,0,0,2
e58209c2-fa28-4b13-b32f-fd0143c887bc,5,0,1,0,6
e592d962-46ec-4361-b1cd-b88ca148df9e,0,2,0,0,2
e5be3496-b92e-4c62-a3ab-29ce173043ae,0,4,0,1,5
e5dbfd82-a82f-46e1-a4b3-08e76a3302be,5,0,1,0,6
e68138c9-ee48-4bd3-834f-9f535cda8f4b,0,5,1,1,7
e69ceb96-74d4-416f-9368-3695340ef62c,0,5,1,1,7
e6ac2bb8-a007-4199-bbc7-5484ba22836e,5,0,0,4,9
e6f15f96-cb95-47e8-b644-f0e6a54dfcc1,6,0,1,1,8
e75bd264-e3e8-49b1-beb3-58dfcfe63ef1,2,0,0,0,2
e7677158-3a8b-4fd1-afa9-45cc627bfc78,0,2,0,0,2
e77a4bdd-0303-4c16-a359-6c7d5805839a,0,3,0,2,5
e7beb4ad-9ed7-4bea-a4cf-f50ce2687ddd,0,3,0,6,9
e8a63e7c-db77-4ff1-bec4-7b6429de7a45,0,4,1,7,12
e93db083-1654-4e5f-b639-f77b2611ee05,0,2,0,0,2
e9a378ab-031d-4f7a-8465-e2b3e90e1adf,0,8,2,1,11
e9a7be6c-bcc0-4725-996f-4b8f86ed063f,0,6,1,0,7
e9aa44dd-8fc2-402b-bb18-5b445dcf0dbc,0,3,0,6,9
e9c8aa06-3e34-4ba9-86c5-dc95cc6989d4,0,2,0,0,2
ea783f28-1da9-423b-b1b5-13f78d7c42b1,0,6,1,0,7
eae6bb87-0314-4483-bbf4-50256eff4580,0,3,0,2,5
eaf86574-2914-46f7-b762-ab21ef9246ff,0,2,0,0,2
eb0c56ef-5c28-448a-8b12-0eef9723608c,0,4,0,6,10
eb3dc993-c338-482f-9f01-412f31d4cc97,1,1,0,0,2
eb5c640d-b8c4-40f0-aaae-bfef3e4cb69e,0,2,0,0,2
eb6ad6cb-8937-446b-b13f-3566314a53a4,0,4,1,6,11
ebeaee6b-68ac-4a14-905a-c466d0fd76fd,0,2,0,0,2
ec15239d-f1dc-4a13-8f3a-adfb6115cbc2,0,2,0,0,2
ec912c1f-587e-4f55-81dd-cb47a3037299,0,3,0,2,5
ed222168-4008-497e-a1c0-9a537759088a,0,3,0,2,5
ed659311-c5fd-4b8e-a304-05ecf39ee96f,0,5,1,1,7
ed7061a0-20f0-4b7b-98c6-3fa10990def3,1,1,0,0,2
ed750a46-62b2-47a1-83e8-65b41e51ae33,0,6,0,3,9
ee8f817c-370f-47c4-bca6-50b653ed12ac,0,3,0,2,5
eed679c1-c529-47b7-a50a-fa4a4eaae1d2,0,3,0,2,5
eeefbe98-7aa8-455a-bfd5-3df8aae4bfd9,0,2,0,0,2
f0970019-2092-495a-b574-3e10de681ec0,0,4,1,9,14
f195f94f-9b4e-412f-94f6-1d96f3e43c0e,0,2,0,0,2
f1a86e89-f8ef-4100-a36c-63960ad198cc,0,8,2,1,11
f1e2698c-084f-449a-9111-b62534cbfcdb,0,2,0,0,2
f219470e-3f35-4fbf-bda7-30b03c5e7cd0,0,4,1,2,7
f39c9d06-6be5-42a2-b6b0-99dd38d30996,0,4,1,6,11
f3d9f6b8-e428-4051-b004-2eaabb3151b8,0,2,0,0,2
f4537d5f-c8fb-4718-ac11-ddebdb736b97,0,2,0,1,3
f45f75d4-7b75-43a1-9e83-87cf65b66ed1,0,1,0,0,1
f4cf5776-2dbb-4d03-bb5f-1a986dd6dc74,0,2,0,0,2
f51a30a6-b62f-4906-8376-ccbc914a62a0,0,6,1,0,7
f5650c51-f206-4512-af8a-481358692f53,0,2,0,5,7
f5ea85de-562b-4cb9-b269-77e4a93140f3,7,0,1,1,9
f6306cd6-b2c3-47df-8075-5beb27b933fc,0,2,0,0,2
f64f55e5-383c-444c-a8b2-381adf4a12a0,6,0,0,2,8
f65c8c1c-9986-4630-a938-d3f7e0b339d9,0,8,2,1,11
f698afa8-b33d-4775-93cc-d028828e670b,0,2,0,0,2
f69a7a5e-bf39-4775-ada6-0e252397cc7c,0,2,0,0,2
f6a4ec38-a8c6-4f4c-a884-93d5b87800ba,4,0,1,7,12
f71ededa-4e09-4c23-8756-4ed9fbf76bfb,4,0,1,5,10
f7d67ce2-36e1-4c89-ad3d-dde97a573fd5,0,6,1,1,8
f8ba54cd-eb9f-4cac-8db2-952c404c102e,0,2,0,0,2
f9012ca8-f111-4e0f-b795-162bf7a72590,0,4,1,2,7
f9e86a33-873c-4ebf-9e72-ca04ab71d987,0,2,0,0,2
fa3cbc56-6b11-4957-9bb1-a712c5fd55f3,0,5,1,0,6
fa49eae5-d954-4f58-a207-4dc1ce0d4714,0,8,2,0,10
fac76122-e619-4e52-8c84-c91407f85c8e,0,5,0,4,9
fae04a67-49f0-4632-b5de-5f5fee08e5bc,7,0,1,2,10
fb929c92-59e2-4a48-92de-9c7a49e69139,2,0,0,0,2
fbc2dd14-3a86-4be1-aac2-f22602662cd0,1,1,0,5,7
fc1f413b-b467-416e-8af7-f75ec19a9f04,0,3,0,2,5
fc429041-1b14-41e0-b142-f6259e3fcc05,0,2,0,0,2
fc55f201-5aff-4896-9b0a-0dd21b9510cb,0,4,1,8,13
fc87fb1b-c9e8-40e9-bdd5-d96e97fe6c18,0,2,0,0,2
fd9c1260-9c07-42d4-996d-d6c78f25acc9,0,2,0,0,2
fefb6a47-a685-4e14-84dc-8918b45694ca,0,2,0,0,2
ff62b923-a951-48d7-b3b0-2373e630edc4,0,3,0,7,10
